..........
#P......K.
#..#####..
#.T....B..
..####.###
..C..V.#M.
..####.#..
#.T..T.#S.
###.......
.........R
