##########
#P#...#T.#
#.###.#V.#
#...#.#..#
###.#C#T.#
#K..#.#B.#
#.#T#.#M.#
#.#...#T.#
#.##R##SK#
##########
