##########
#P#...#T.#
#.###.#V.#
#...#.#..#
###.#C#T.#
#K..#.#B.#
#.#T#.#M.#
#.#...#..#
#.##R##S.#
##########
