.....#####
#P..T...K#
#.#.#.#...
#.C.#.V.B#
###.#.#.#.
#...T...M#
#.#.#.#.#.
#.T.#...S#
#........#
#####....R
