..........
.P....##..
...C..#BT#
##.##.####
.#..T.M...
.C..T....V
K......###
..#T..T...
..#.R..S..
..####....
