##########
#P.......#
#..C..T..#
##.##.####
#...T....#
#K..B..M.#
#....V...#
#..T..T..#
#...R..S.#
##########
