##########
#P.......#
#..C..T..#
##.##.####
#...T....#
#C..T..K.#
#....V...#
#..T..T..#
#...R.BSK#
##########
