..........
.P....##..
...C..#BT#
##.##.####
.#..T.....
.C..T....V
K......###
..#T..T...
..#.R..S..
..####....
