##########
#P.......#
###.####.#
#T#....C.#
#.#.K.B.M#
#.V....#S#
#.#.####.#
#.T..R.T.#
#.C.....#.#
##########
