....#..C..
#P..#....#
###.#....#
#T#.#....#
#.#.K.B.M#
#.V...#.S#
#.#.###..#
#.T.#R.T.#
#.C.##...#
.......T..
